[
    "age_0",
    "age_1",
    "age_2",
    "age_3",
    "age_4",
    "age_5",
    "age_6",
    "age_7",
    "age_8",
    "age_9"
]
